Rank,Country,NPC,Gold,Silver,Bronze,Total,Event,Year
1,Italy,ITA,29,28,23,80,Rome,1960
2,Great Britain,GBR,20,15,20,55,Rome,1960
3,Germany,GER,15,6,9,30,Rome,1960
4,Austria,AUT,11,8,11,30,Rome,1960
5,United States of America,USA,11,7,7,25,Rome,1960
6,Norway,NOR,9,3,4,16,Rome,1960
7,Australia,AUS,3,6,1,10,Rome,1960
8,Netherlands,NED,3,6,0,9,Rome,1960
9,France,FRA,3,3,1,7,Rome,1960
10,Argentina,ARG,2,3,1,6,Rome,1960
11,Rhodesia,RHO,2,1,2,5,Rome,1960
12,Ireland,IRL,2,0,0,2,Rome,1960
13,Switzerland,SUI,1,3,0,4,Rome,1960
14,Belgium,BEL,1,1,1,3,Rome,1960
15,Finland,FIN,1,0,0,1,Rome,1960
16,Israel,ISR,0,2,2,4,Rome,1960
16,Malta,MLT,0,2,2,4,Rome,1960
1,United States of America,USA,50,41,32,123,Tokyo,1964
2,Great Britain,GBR,18,23,20,61,Tokyo,1964
3,Italy,ITA,14,15,16,45,Tokyo,1964
4,Australia,AUS,12,11,7,30,Tokyo,1964
5,Rhodesia,RHO,10,5,2,17,Tokyo,1964
6,South Africa,RSA,8,8,3,19,Tokyo,1964
7,Israel,ISR,7,3,11,21,Tokyo,1964
8,Argentina,ARG,6,15,16,37,Tokyo,1964
9,Germany,GER,5,2,5,12,Tokyo,1964
10,Netherlands,NED,4,6,4,14,Tokyo,1964
11,France,FRA,4,2,5,11,Tokyo,1964
12,Austria,AUT,4,1,7,12,Tokyo,1964
13,Japan,JPN,1,5,4,10,Tokyo,1964
14,Belgium,BEL,1,0,2,3,Tokyo,1964
15,Switzerland,SUI,0,1,0,1,Tokyo,1964
16,Malta,MLT,0,0,2,2,Tokyo,1964
17,Sweden,SWE,0,0,1,1,Tokyo,1964
1,United States of America,USA,33,27,39,99,TelAviv,1968
2,Great Britain,GBR,29,20,20,69,TelAviv,1968
3,Israel,ISR,18,21,23,62,TelAviv,1968
4,Australia,AUS,15,16,7,38,TelAviv,1968
5,France,FRA,13,10,9,32,TelAviv,1968
6,West Germany,FRG,12,12,11,35,TelAviv,1968
7,Italy,ITA,12,10,17,39,TelAviv,1968
8,Netherlands,NED,12,4,4,20,TelAviv,1968
9,Argentina,ARG,10,10,10,30,TelAviv,1968
10,South Africa,RSA,9,10,7,26,TelAviv,1968
11,Rhodesia,RHO,6,7,7,20,TelAviv,1968
12,Canada,CAN,6,6,7,19,TelAviv,1968
13,Norway,NOR,5,3,1,9,TelAviv,1968
14,Jamaica,JAM,3,1,1,5,TelAviv,1968
15,Austria,AUT,2,7,10,19,TelAviv,1968
16,Japan,JPN,2,2,8,12,TelAviv,1968
17,Sweden,SWE,1,6,4,11,TelAviv,1968
18,New Zealand,NZL,1,2,1,4,TelAviv,1968
19,Ireland,IRL,0,4,5,9,TelAviv,1968
20,Belgium,BEL,0,3,3,6,TelAviv,1968
21,Spain,ESP,0,3,1,4,TelAviv,1968
22,Switzerland,SUI,0,2,6,8,TelAviv,1968
1,West Germany,FRG,28,17,22,67,Heidelberg,1972
2,United States of America,USA,17,27,31,75,Heidelberg,1972
3,Great Britain,GBR,16,15,21,52,Heidelberg,1972
4,South Africa,RSA,16,12,13,41,Heidelberg,1972
5,Netherlands,NED,14,13,11,38,Heidelberg,1972
6,Poland,POL,14,12,7,33,Heidelberg,1972
7,France,FRA,10,8,15,33,Heidelberg,1972
8,Israel,ISR,9,10,9,28,Heidelberg,1972
9,Italy,ITA,8,4,5,17,Heidelberg,1972
10,Jamaica,JAM,8,3,4,15,Heidelberg,1972
11,Australia,AUS,6,9,10,25,Heidelberg,1972
12,Austria,AUT,6,6,6,18,Heidelberg,1972
13,Canada,CAN,5,6,8,19,Heidelberg,1972
14,Sweden,SWE,5,6,6,17,Heidelberg,1972
15,Japan,JPN,4,5,3,12,Heidelberg,1972
16,Republic of Korea,KOR,4,2,1,7,Heidelberg,1972
17,Rhodesia,RHO,3,5,4,12,Heidelberg,1972
18,New Zealand,NZL,3,3,3,9,Heidelberg,1972
19,Switzerland,SUI,3,2,4,9,Heidelberg,1972
20,Argentina,ARG,2,4,3,9,Heidelberg,1972
21,Ireland,IRL,2,4,2,8,Heidelberg,1972
22,Norway,NOR,1,5,4,10,Heidelberg,1972
23,Belgium,BEL,1,1,2,4,Heidelberg,1972
23,Yugoslavia,YUG,1,1,2,4,Heidelberg,1972
24,India,IND,1,0,0,1,Heidelberg,1972
24,Kenya,KEN,1,0,0,1,Heidelberg,1972
25,Spain,ESP,0,4,0,4,Heidelberg,1972
26,Finland,FIN,0,2,1,3,Heidelberg,1972
27,"Hong Kong, China",HKG,0,1,1,2,Heidelberg,1972
28,Czechoslovakia,TCH,0,0,1,1,Heidelberg,1972
28,Hungary,HUN,0,0,1,1,Heidelberg,1972
1,West Germany,FRG,10,12,6,28,Ornskoldsvik,1976
2,Switzerland,SUI,10,1,1,12,Ornskoldsvik,1976
3,Finland,FIN,8,7,7,22,Ornskoldsvik,1976
4,Norway,NOR,7,3,2,12,Ornskoldsvik,1976
5,Sweden,SWE,6,7,7,20,Ornskoldsvik,1976
6,Austria,AUT,5,16,14,35,Ornskoldsvik,1976
7,Czechoslovakia,TCH,3,0,0,3,Ornskoldsvik,1976
8,France,FRA,2,0,3,5,Ornskoldsvik,1976
9,Canada,CAN,2,0,2,4,Ornskoldsvik,1976
1,United States of America,USA,66,44,45,155,Toronto,1976
2,Netherlands,NED,45,25,14,84,Toronto,1976
3,Israel,ISR,40,13,16,69,Toronto,1976
4,West Germany,FRG,37,34,26,97,Toronto,1976
5,Great Britain,GBR,29,28,37,94,Toronto,1976
6,Canada,CAN,25,26,26,77,Toronto,1976
7,Poland,POL,24,17,12,53,Toronto,1976
8,France,FRA,23,21,14,58,Toronto,1976
9,Sweden,SWE,21,28,25,74,Toronto,1976
10,Austria,AUT,18,16,17,51,Toronto,1976
11,Australia,AUS,16,18,7,41,Toronto,1976
12,Mexico,MEX,16,14,9,39,Toronto,1976
13,Finland,FIN,12,20,18,50,Toronto,1976
14,Japan,JPN,10,6,3,19,Toronto,1976
15,Switzerland,SUI,9,12,10,31,Toronto,1976
16,Norway,NOR,9,6,4,19,Toronto,1976
17,Belgium,BEL,7,7,8,22,Toronto,1976
18,New Zealand,NZL,7,1,5,13,Toronto,1976
19,South Africa,RSA,6,9,11,26,Toronto,1976
20,Egypt,EGY,5,2,1,8,Toronto,1976
21,Ireland,IRL,4,10,6,20,Toronto,1976
22,Spain,ESP,4,6,2,12,Toronto,1976
23,Argentina,ARG,3,4,7,14,Toronto,1976
24,Denmark,DEN,3,0,3,6,Toronto,1976
25,Italy,ITA,2,5,11,18,Toronto,1976
26,Indonesia,INA,2,1,3,6,Toronto,1976
27,Republic of Korea,KOR,1,2,1,4,Toronto,1976
28,Burma,BIR,1,1,1,3,Toronto,1976
29,Peru,PER,1,0,2,3,Toronto,1976
30,Hungary,HUN,1,0,1,2,Toronto,1976
31,"Hong Kong, China",HKG,0,1,2,3,Toronto,1976
32,Brazil,BRA,0,1,0,1,Toronto,1976
33,Guatemala,GUA,0,0,1,1,Toronto,1976
1,Norway,NOR,23,21,10,54,Geilo,1980
2,Finland,FIN,16,7,12,35,Geilo,1980
3,Austria,AUT,6,10,6,22,Geilo,1980
4,Sweden,SWE,5,3,8,16,Geilo,1980
5,Switzerland,SUI,4,2,4,10,Geilo,1980
6,United States of America,USA,4,1,1,6,Geilo,1980
7,West Germany,FRG,3,6,9,18,Geilo,1980
8,Canada,CAN,2,3,1,6,Geilo,1980
9,France,FRA,1,1,1,3,Geilo,1980
10,,TCH,0,1,0,1,Geilo,1980
1,United States of America,USA,75,66,54,195,Arnhem,1980
2,Poland,POL,75,50,52,177,Arnhem,1980
3,West Germany,FRG,68,48,46,162,Arnhem,1980
4,Canada,CAN,64,35,31,130,Arnhem,1980
5,Great Britain,GBR,47,32,21,100,Arnhem,1980
6,Netherlands,NED,33,31,36,100,Arnhem,1980
7,Sweden,SWE,31,36,24,91,Arnhem,1980
8,France,FRA,28,26,31,85,Arnhem,1980
9,Mexico,MEX,20,16,6,42,Arnhem,1980
10,Norway,NOR,15,13,8,36,Arnhem,1980
11,Austria,AUT,14,23,8,45,Arnhem,1980
12,Israel,ISR,13,18,15,46,Arnhem,1980
13,Belgium,BEL,13,12,17,42,Arnhem,1980
14,Australia,AUS,12,21,22,55,Arnhem,1980
15,Switzerland,SUI,9,10,10,29,Arnhem,1980
16,Japan,JPN,9,10,7,26,Arnhem,1980
17,Finland,FIN,8,19,13,40,Arnhem,1980
18,Jamaica,JAM,7,7,5,19,Arnhem,1980
19,New Zealand,NZL,7,6,6,19,Arnhem,1980
20,Italy,ITA,6,5,9,20,Arnhem,1980
21,Denmark,DEN,6,4,7,17,Arnhem,1980
22,Egypt,EGY,4,7,3,14,Arnhem,1980
23,Yugoslavia,YUG,4,5,9,18,Arnhem,1980
24,Argentina,ARG,4,5,6,15,Arnhem,1980
25,Ireland,IRL,4,2,11,17,Arnhem,1980
26,Republic of Korea,KOR,2,2,1,5,Arnhem,1980
26,Kuwait,KUW,2,2,1,5,Arnhem,1980
27,Indonesia,INA,2,0,4,6,Arnhem,1980
28,Spain,ESP,1,13,9,23,Arnhem,1980
29,Kenya,KEN,1,2,0,3,Arnhem,1980
30,Colombia,COL,1,0,1,2,Arnhem,1980
30,Iceland,ISL,1,0,1,2,Arnhem,1980
31,Sudan,SUD,1,0,0,1,Arnhem,1980
32,Zimbabwe,ZIM,0,8,4,12,Arnhem,1980
33,Bahamas,BAH,0,1,2,3,Arnhem,1980
33,"Hong Kong, China",HKG,0,1,2,3,Arnhem,1980
34,Czechoslovakia,TCH,0,1,1,2,Arnhem,1980
35,Greece,GRE,0,0,1,1,Arnhem,1980
35,Luxembourg,LUX,0,0,1,1,Arnhem,1980
35,Malta,MLT,0,0,1,1,Arnhem,1980
1,Austria,AUT,34,19,17,70,Innsbruck,1984
2,Finland,FIN,19,9,6,34,Innsbruck,1984
3,Norway,NOR,15,13,13,41,Innsbruck,1984
4,West Germany,FRG,10,14,10,34,Innsbruck,1984
5,United States of America,USA,7,14,14,35,Innsbruck,1984
6,Sweden,SWE,7,2,5,14,Innsbruck,1984
7,Switzerland,SUI,5,16,16,37,Innsbruck,1984
8,France,FRA,4,2,0,6,Innsbruck,1984
9,Poland,POL,3,2,8,13,Innsbruck,1984
10,Canada,CAN,2,8,4,14,Innsbruck,1984
11,New Zealand,NZL,1,3,1,5,Innsbruck,1984
12,Great Britain,GBR,0,4,6,10,Innsbruck,1984
13,Italy,ITA,0,0,1,1,Innsbruck,1984
13,,YUG,0,0,1,1,Innsbruck,1984
1,United States of America,USA,137,131,129,397,StokeMandevilleNewYork,1984
2,Great Britain,GBR,107,112,112,331,StokeMandevilleNewYork,1984
3,Canada,CAN,87,82,69,238,StokeMandevilleNewYork,1984
4,Sweden,SWE,83,43,34,160,StokeMandevilleNewYork,1984
5,West Germany,FRG,81,76,75,232,StokeMandevilleNewYork,1984
6,France,FRA,71,69,46,186,StokeMandevilleNewYork,1984
7,Netherlands,NED,55,52,28,135,StokeMandevilleNewYork,1984
8,Australia,AUS,49,54,51,154,StokeMandevilleNewYork,1984
9,Poland,POL,46,39,21,106,StokeMandevilleNewYork,1984
10,Norway,NOR,30,30,30,90,StokeMandevilleNewYork,1984
11,Denmark,DEN,30,13,16,59,StokeMandevilleNewYork,1984
12,Spain,ESP,22,10,12,44,StokeMandevilleNewYork,1984
13,Belgium,BEL,21,23,14,58,StokeMandevilleNewYork,1984
14,Ireland,IRL,20,15,31,66,StokeMandevilleNewYork,1984
15,Finland,FIN,18,14,27,59,StokeMandevilleNewYork,1984
16,Switzerland,SUI,18,13,12,43,StokeMandevilleNewYork,1984
17,Austria,AUT,14,20,10,44,StokeMandevilleNewYork,1984
18,Hungary,HUN,12,13,3,28,StokeMandevilleNewYork,1984
19,Israel,ISR,11,21,12,44,StokeMandevilleNewYork,1984
20,Yugoslavia,YUG,11,10,11,32,StokeMandevilleNewYork,1984
21,Italy,ITA,9,19,14,42,StokeMandevilleNewYork,1984
22,Japan,JPN,9,7,8,24,StokeMandevilleNewYork,1984
23,New Zealand,NZL,8,10,7,25,StokeMandevilleNewYork,1984
24,Brazil,BRA,7,17,4,28,StokeMandevilleNewYork,1984
25,Mexico,MEX,6,14,17,37,StokeMandevilleNewYork,1984
26,Portugal,POR,4,3,7,14,StokeMandevilleNewYork,1984
27,"Hong Kong, China",HKG,3,5,9,17,StokeMandevilleNewYork,1984
28,People's Republic of China,CHN,2,12,8,22,StokeMandevilleNewYork,1984
29,Trinidad and Tobago,TTO,2,0,1,3,StokeMandevilleNewYork,1984
30,Luxembourg,LUX,1,4,1,6,StokeMandevilleNewYork,1984
31,Kuwait,KUW,1,3,4,8,StokeMandevilleNewYork,1984
32,Burma,BIR,1,2,1,4,StokeMandevilleNewYork,1984
33,Egypt,EGY,1,1,5,7,StokeMandevilleNewYork,1984
34,Kenya,KEN,1,1,1,3,StokeMandevilleNewYork,1984
35,East Germany,GDR,0,3,1,4,StokeMandevilleNewYork,1984
36,Iceland,ISL,0,2,8,10,StokeMandevilleNewYork,1984
37,India,IND,0,2,2,4,StokeMandevilleNewYork,1984
37,Republic of Korea,KOR,0,2,2,4,StokeMandevilleNewYork,1984
38,Jordan,JOR,0,1,2,3,StokeMandevilleNewYork,1984
38,Zimbabwe,ZIM,0,1,2,3,StokeMandevilleNewYork,1984
39,Bahamas,BAH,0,1,1,2,StokeMandevilleNewYork,1984
39,Indonesia,INA,0,1,1,2,StokeMandevilleNewYork,1984
40,Bahrain,BRN,0,0,2,2,StokeMandevilleNewYork,1984
1,Norway,NOR,25,21,14,60,Innsbruck,1988
2,Austria,AUT,20,10,14,44,Innsbruck,1988
3,West Germany,FRG,9,11,10,30,Innsbruck,1988
4,Finland,FIN,9,8,8,25,Innsbruck,1988
5,Switzerland,SUI,8,7,8,23,Innsbruck,1988
6,United States of America,USA,7,17,6,30,Innsbruck,1988
7,France,FRA,5,5,3,13,Innsbruck,1988
8,Canada,CAN,5,3,5,13,Innsbruck,1988
9,Sweden,SWE,3,7,5,15,Innsbruck,1988
10,Italy,ITA,3,0,6,9,Innsbruck,1988
11,Spain,ESP,1,2,1,4,Innsbruck,1988
12,Poland,POL,1,1,6,8,Innsbruck,1988
13,New Zealand,NZL,0,1,0,1,Innsbruck,1988
14,Japan,JPN,0,0,2,2,Innsbruck,1988
14,,URS,0,0,2,2,Innsbruck,1988
1,United States of America,USA,91,90,88,269,Seoul,1988
2,West Germany,FRG,76,65,52,193,Seoul,1988
3,Great Britain,GBR,65,65,54,184,Seoul,1988
4,Canada,CAN,55,42,55,152,Seoul,1988
5,France,FRA,46,44,50,140,Seoul,1988
6,Sweden,SWE,42,38,23,103,Seoul,1988
7,Republic of Korea,KOR,40,35,19,94,Seoul,1988
8,Netherlands,NED,30,24,29,83,Seoul,1988
9,Australia,AUS,23,34,38,95,Seoul,1988
10,Poland,POL,23,25,33,81,Seoul,1988
11,Denmark,DEN,23,19,22,64,Seoul,1988
12,USSR,URS,21,20,15,56,Seoul,1988
13,Spain,ESP,18,13,12,43,Seoul,1988
14,Japan,JPN,17,12,17,46,Seoul,1988
15,People's Republic of China,CHN,16,17,8,41,Seoul,1988
16,Italy,ITA,16,15,27,58,Seoul,1988
17,Belgium,BEL,15,18,8,41,Seoul,1988
18,Israel,ISR,15,14,16,45,Seoul,1988
19,Ireland,IRL,13,11,18,42,Seoul,1988
20,Austria,AUT,13,7,15,35,Seoul,1988
21,Switzerland,SUI,12,12,11,35,Seoul,1988
22,Finland,FIN,11,23,16,50,Seoul,1988
23,Norway,NOR,11,11,15,37,Seoul,1988
24,Mexico,MEX,8,9,7,24,Seoul,1988
25,Kuwait,KUW,5,5,7,17,Seoul,1988
26,Brazil,BRA,4,9,14,27,Seoul,1988
27,Yugoslavia,YUG,4,4,11,19,Seoul,1988
28,Islamic Republic of Iran,IRI,4,1,3,8,Seoul,1988
29,Portugal,POR,3,5,6,14,Seoul,1988
30,New Zealand,NZL,2,4,11,17,Seoul,1988
31,Iceland,ISL,2,2,7,11,Seoul,1988
32,Bulgaria,BUL,2,1,0,3,Seoul,1988
33,Jamaica,JAM,1,4,3,8,Seoul,1988
34,Egypt,EGY,1,3,3,7,Seoul,1988
34,Faroe Islands,FRO,1,3,3,7,Seoul,1988
35,Puerto Rico,PUR,1,2,0,3,Seoul,1988
36,Bahrain,BRN,1,1,1,3,Seoul,1988
37,Guatemala,GUA,1,0,0,1,Seoul,1988
38,Argentina,ARG,0,7,2,9,Seoul,1988
39,Hungary,HUN,0,5,7,12,Seoul,1988
40,Kenya,KEN,0,4,1,5,Seoul,1988
41,"Hong Kong, China",HKG,0,2,7,9,Seoul,1988
42,Indonesia,INA,0,2,0,2,Seoul,1988
43,Greece,GRE,0,1,3,4,Seoul,1988
44,Czechoslovakia,TCH,0,1,0,1,Seoul,1988
44,Thailand,THA,0,1,0,1,Seoul,1988
45,Tunisia,TUN,0,0,2,2,Seoul,1988
46,Malaysia,MAS,0,0,1,1,Seoul,1988
46,Morocco,MAR,0,0,1,1,Seoul,1988
1,United States of America,USA,20,16,9,45,TignesAlbertville,1992
2,Germany,GER,12,17,9,38,TignesAlbertville,1992
3,Unified Team,EUN,10,8,3,21,TignesAlbertville,1992
4,Austria,AUT,8,3,9,20,TignesAlbertville,1992
5,Finland,FIN,7,3,4,14,TignesAlbertville,1992
6,France,FRA,6,4,9,19,TignesAlbertville,1992
7,Norway,NOR,5,5,4,14,TignesAlbertville,1992
8,Switzerland,SUI,3,8,4,15,TignesAlbertville,1992
9,Canada,CAN,2,4,6,12,TignesAlbertville,1992
10,Poland,POL,2,0,3,5,TignesAlbertville,1992
11,New Zealand,NZL,2,0,0,2,TignesAlbertville,1992
12,Australia,AUS,1,1,2,4,TignesAlbertville,1992
12,Sweden,SWE,1,1,2,4,TignesAlbertville,1992
13,Czechoslovakia,TCH,0,4,2,6,TignesAlbertville,1992
14,Great Britain,GBR,0,1,4,5,TignesAlbertville,1992
15,Italy,ITA,0,1,3,4,TignesAlbertville,1992
15,Spain,ESP,0,1,3,4,TignesAlbertville,1992
16,Denmark,DEN,0,1,0,1,TignesAlbertville,1992
17,Japan,JPN,0,0,2,2,TignesAlbertville,1992
1,United States of America,USA,75,52,48,175,Barcelona,1992
2,Germany,GER,61,51,59,171,Barcelona,1992
3,Great Britain,GBR,40,47,41,128,Barcelona,1992
4,France,FRA,36,36,34,106,Barcelona,1992
5,Spain,ESP,34,31,42,107,Barcelona,1992
6,Canada,CAN,28,21,26,75,Barcelona,1992
7,Australia,AUS,24,27,25,76,Barcelona,1992
8,Unified Team,EUN,16,14,15,45,Barcelona,1992
9,Netherlands,NED,14,14,11,39,Barcelona,1992
10,Norway,NOR,13,13,7,33,Barcelona,1992
11,Denmark,DEN,12,22,12,46,Barcelona,1992
12,Republic of Korea,KOR,11,15,18,44,Barcelona,1992
13,People's Republic of China,CHN,11,7,7,25,Barcelona,1992
14,Poland,POL,10,12,10,32,Barcelona,1992
15,Italy,ITA,10,7,18,35,Barcelona,1992
16,Japan,JPN,8,7,15,30,Barcelona,1992
17,Finland,FIN,8,6,11,25,Barcelona,1992
18,Sweden,SWE,7,22,9,38,Barcelona,1992
19,Egypt,EGY,7,6,7,20,Barcelona,1992
20,Switzerland,SUI,6,16,13,35,Barcelona,1992
21,Belgium,BEL,5,5,7,17,Barcelona,1992
22,Austria,AUT,5,4,13,22,Barcelona,1992
23,New Zealand,NZL,5,1,0,6,Barcelona,1992
24,Czechoslovakia,TCH,4,3,6,13,Barcelona,1992
25,Hungary,HUN,4,3,4,11,Barcelona,1992
26,Independent Paralympic Participants,IPP,4,3,1,8,Barcelona,1992
27,South Africa,RSA,4,1,3,8,Barcelona,1992
28,"Hong Kong, China",HKG,3,4,4,11,Barcelona,1992
29,Cuba,CUB,3,3,3,9,Barcelona,1992
29,Portugal,POR,3,3,3,9,Barcelona,1992
30,Iceland,ISL,3,2,12,17,Barcelona,1992
31,Brazil,BRA,3,0,4,7,Barcelona,1992
32,Nigeria,NGR,3,0,0,3,Barcelona,1992
33,Israel,ISR,2,4,5,11,Barcelona,1992
34,Slovenia,SLO,2,0,1,3,Barcelona,1992
35,Kuwait,KUW,1,3,1,5,Barcelona,1992
36,Islamic Republic of Iran,IRI,1,2,1,4,Barcelona,1992
37,Bulgaria,BUL,1,2,0,3,Barcelona,1992
37,Panama,PAN,1,2,0,3,Barcelona,1992
38,Argentina,ARG,1,1,0,2,Barcelona,1992
39,Kenya,KEN,1,0,1,2,Barcelona,1992
40,Lithuania,LTU,0,4,3,7,Barcelona,1992
41,Ireland,IRL,0,3,4,7,Barcelona,1992
42,Estonia,EST,0,2,1,3,Barcelona,1992
42,Greece,GRE,0,2,1,3,Barcelona,1992
43,Mexico,MEX,0,1,10,11,Barcelona,1992
44,Jamaica,JAM,0,1,2,3,Barcelona,1992
44,Malaysia,MAS,0,1,2,3,Barcelona,1992
45,Faroe Islands,FRO,0,1,0,1,Barcelona,1992
46,Bahrain,BRN,0,0,1,1,Barcelona,1992
46,Chinese Taipei,TPE,0,0,1,1,Barcelona,1992
46,Croatia,CRO,0,0,1,1,Barcelona,1992
46,Iraq,IRQ,0,0,1,1,Barcelona,1992
46,Thailand,THA,0,0,1,1,Barcelona,1992
46,Venezuela,VEN,0,0,1,1,Barcelona,1992
1,Norway,NOR,29,22,13,64,Lillehammer,1994
2,Germany,GER,25,21,18,64,Lillehammer,1994
3,United States of America,USA,24,12,7,43,Lillehammer,1994
4,France,FRA,14,6,11,31,Lillehammer,1994
5,Russian Federation,RUS,10,12,8,30,Lillehammer,1994
6,Austria,AUT,7,16,12,35,Lillehammer,1994
7,Finland,FIN,7,6,11,24,Lillehammer,1994
8,Sweden,SWE,3,3,2,8,Lillehammer,1994
9,Australia,AUS,3,2,4,9,Lillehammer,1994
10,New Zealand,NZL,3,0,3,6,Lillehammer,1994
11,Switzerland,SUI,2,9,5,16,Lillehammer,1994
12,Poland,POL,2,3,5,10,Lillehammer,1994
13,Spain,ESP,1,6,3,10,Lillehammer,1994
14,Canada,CAN,1,2,5,8,Lillehammer,1994
15,Netherlands,NED,1,0,3,4,Lillehammer,1994
16,Denmark,DEN,1,0,2,3,Lillehammer,1994
17,Italy,ITA,0,7,6,13,Lillehammer,1994
18,Japan,JPN,0,3,3,6,Lillehammer,1994
19,Slovakia,SVK,0,3,2,5,Lillehammer,1994
20,Kazakhstan,KAZ,0,1,0,1,Lillehammer,1994
21,Great Britain,GBR,0,0,5,5,Lillehammer,1994
22,Belgium,BEL,0,0,1,1,Lillehammer,1994
22,Czech Republic,CZE,0,0,1,1,Lillehammer,1994
22,Estonia,EST,0,0,1,1,Lillehammer,1994
22,Liechtenstein,LIE,0,0,1,1,Lillehammer,1994
1,United States of America,USA,46,46,65,157,Atlanta,1996
2,Australia,AUS,42,37,27,106,Atlanta,1996
3,Germany,GER,40,58,51,149,Atlanta,1996
4,Great Britain,GBR,39,42,41,122,Atlanta,1996
5,Spain,ESP,39,31,36,106,Atlanta,1996
6,France,FRA,35,29,31,95,Atlanta,1996
7,Canada,CAN,24,21,24,69,Atlanta,1996
8,Netherlands,NED,17,11,17,45,Atlanta,1996
9,People's Republic of China,CHN,16,13,10,39,Atlanta,1996
10,Japan,JPN,14,10,13,37,Atlanta,1996
11,Poland,POL,13,14,8,35,Atlanta,1996
12,Republic of Korea,KOR,13,2,15,30,Atlanta,1996
13,Sweden,SWE,12,14,11,37,Atlanta,1996
14,Italy,ITA,11,20,14,45,Atlanta,1996
15,South Africa,RSA,10,8,10,28,Atlanta,1996
16,Russian Federation,RUS,9,7,11,27,Atlanta,1996
17,Norway,NOR,9,7,4,20,Atlanta,1996
18,Switzerland,SUI,9,6,6,21,Atlanta,1996
19,New Zealand,NZL,9,6,3,18,Atlanta,1996
20,Islamic Republic of Iran,IRI,9,5,3,17,Atlanta,1996
21,Egypt,EGY,8,11,11,30,Atlanta,1996
22,Belgium,BEL,8,10,7,25,Atlanta,1996
23,Cuba,CUB,8,3,0,11,Atlanta,1996
24,Denmark,DEN,7,17,17,41,Atlanta,1996
25,Austria,AUT,6,6,10,22,Atlanta,1996
26,Portugal,POR,6,4,4,14,Atlanta,1996
27,"Hong Kong, China",HKG,5,5,5,15,Atlanta,1996
28,Iceland,ISL,5,4,5,14,Atlanta,1996
29,Hungary,HUN,5,2,3,10,Atlanta,1996
30,Finland,FIN,4,5,4,13,Atlanta,1996
31,Mexico,MEX,3,5,4,12,Atlanta,1996
32,Estonia,EST,3,4,2,9,Atlanta,1996
33,Belarus,BLR,3,3,7,13,Atlanta,1996
34,Lithuania,LTU,3,2,6,11,Atlanta,1996
35,Nigeria,NGR,3,2,3,8,Atlanta,1996
36,Czech Republic,CZE,2,7,1,10,Atlanta,1996
37,Brazil,BRA,2,6,13,21,Atlanta,1996
38,Argentina,ARG,2,5,2,9,Atlanta,1996
39,Slovakia,SVK,2,4,5,11,Atlanta,1996
40,Algeria,ALG,2,2,3,7,Atlanta,1996
41,Yugoslavia,YUG,2,2,0,4,Atlanta,1996
42,Côte d'Ivoire,CIV,2,0,0,2,Atlanta,1996
42,Panama,PAN,2,0,0,2,Atlanta,1996
43,Ukraine,UKR,1,4,2,7,Atlanta,1996
44,Ireland,IRL,1,3,6,10,Atlanta,1996
45,Greece,GRE,1,1,3,5,Atlanta,1996
46,Kuwait,KUW,1,1,1,3,Atlanta,1996
47,Kenya,KEN,1,1,0,2,Atlanta,1996
48,Chinese Taipei,TPE,1,0,2,3,Atlanta,1996
49,Dominican Republic,DOM,1,0,0,1,Atlanta,1996
49,Peru,PER,1,0,0,1,Atlanta,1996
50,Israel,ISR,0,4,5,9,Atlanta,1996
51,Slovenia,SLO,0,2,3,5,Atlanta,1996
52,Tunisia,TUN,0,2,0,2,Atlanta,1996
53,Bulgaria,BUL,0,1,1,2,Atlanta,1996
54,Jordan,JOR,0,1,0,1,Atlanta,1996
55,Republic of Moldova,MDA,0,0,2,2,Atlanta,1996
55,Thailand,THA,0,0,2,2,Atlanta,1996
56,Jamaica,JAM,0,0,1,1,Atlanta,1996
56,Uruguay,URU,0,0,1,1,Atlanta,1996
1,Norway,NOR,18,9,13,40,Nagano,1998
2,Germany,GER,14,17,13,44,Nagano,1998
3,United States of America,USA,13,8,13,34,Nagano,1998
4,Japan,JPN,12,16,13,41,Nagano,1998
5,Russian Federation,RUS,12,10,9,31,Nagano,1998
6,Switzerland,SUI,10,5,8,23,Nagano,1998
7,Spain,ESP,8,0,0,8,Nagano,1998
8,Austria,AUT,7,16,11,34,Nagano,1998
9,Finland,FIN,7,5,7,19,Nagano,1998
10,France,FRA,5,9,8,22,Nagano,1998
11,New Zealand,NZL,4,1,1,6,Nagano,1998
12,Italy,ITA,3,4,3,10,Nagano,1998
13,Czech Republic,CZE,3,3,1,7,Nagano,1998
14,Ukraine,UKR,3,2,4,9,Nagano,1998
15,Canada,CAN,1,9,5,15,Nagano,1998
16,Australia,AUS,1,0,1,2,Nagano,1998
16,Denmark,DEN,1,0,1,2,Nagano,1998
17,Slovakia,SVK,0,6,4,10,Nagano,1998
18,Sweden,SWE,0,1,5,6,Nagano,1998
19,Netherlands,NED,0,1,1,2,Nagano,1998
20,Poland,POL,0,0,2,2,Nagano,1998
1,Australia,AUS,63,39,47,149,Sydney,2000
2,Great Britain,GBR,41,43,47,131,Sydney,2000
3,Canada,CAN,38,33,25,96,Sydney,2000
4,Spain,ESP,38,30,38,106,Sydney,2000
5,United States of America,USA,36,39,34,109,Sydney,2000
6,People's Republic of China,CHN,34,22,17,73,Sydney,2000
7,France,FRA,30,28,28,86,Sydney,2000
8,Poland,POL,19,22,12,53,Sydney,2000
9,Republic of Korea,KOR,18,7,7,32,Sydney,2000
10,Germany,GER,16,41,38,95,Sydney,2000
11,Czech Republic,CZE,15,15,13,43,Sydney,2000
12,Japan,JPN,13,17,11,41,Sydney,2000
13,South Africa,RSA,13,12,13,38,Sydney,2000
14,Russian Federation,RUS,12,11,12,35,Sydney,2000
15,Netherlands,NED,12,9,9,30,Sydney,2000
16,Islamic Republic of Iran,IRI,12,4,7,23,Sydney,2000
17,Mexico,MEX,10,12,12,34,Sydney,2000
18,Italy,ITA,9,8,10,27,Sydney,2000
19,Denmark,DEN,8,8,14,30,Sydney,2000
20,Switzerland,SUI,8,4,8,20,Sydney,2000
21,"Hong Kong, China",HKG,8,3,7,18,Sydney,2000
22,Nigeria,NGR,7,1,5,13,Sydney,2000
23,Egypt,EGY,6,12,10,28,Sydney,2000
24,Brazil,BRA,6,10,6,22,Sydney,2000
25,New Zealand,NZL,6,8,4,18,Sydney,2000
26,Portugal,POR,6,5,4,15,Sydney,2000
27,Tunisia,TUN,6,4,1,11,Sydney,2000
28,Belarus,BLR,5,8,10,23,Sydney,2000
29,Sweden,SWE,5,6,10,21,Sydney,2000
30,Thailand,THA,5,4,2,11,Sydney,2000
31,Ireland,IRL,5,3,1,9,Sydney,2000
32,Hungary,HUN,4,5,14,23,Sydney,2000
33,Greece,GRE,4,4,3,11,Sydney,2000
34,Cuba,CUB,4,2,2,8,Sydney,2000
35,Ukraine,UKR,3,20,14,37,Sydney,2000
36,Slovakia,SVK,3,5,5,13,Sydney,2000
37,Israel,ISR,3,2,1,6,Sydney,2000
38,Algeria,ALG,3,0,0,3,Sydney,2000
39,Austria,AUT,2,7,6,15,Sydney,2000
40,Norway,NOR,2,6,7,15,Sydney,2000
41,Iceland,ISL,2,0,2,4,Sydney,2000
42,Belgium,BEL,1,4,4,9,Sydney,2000
43,Finland,FIN,1,3,6,10,Sydney,2000
44,Chinese Taipei,TPE,1,2,4,7,Sydney,2000
45,Estonia,EST,1,1,3,5,Sydney,2000
46,Kenya,KEN,1,1,2,4,Sydney,2000
47,Peru,PER,1,1,0,2,Sydney,2000
48,Côte d'Ivoire,CIV,1,0,1,2,Sydney,2000
49,Bulgaria,BUL,1,0,0,1,Sydney,2000
49,Jordan,JOR,1,0,0,1,Sydney,2000
49,Zimbabwe,ZIM,1,0,0,1,Sydney,2000
50,Faroe Islands,FRO,0,3,1,4,Sydney,2000
50,United Arab Emirates,UAE,0,3,1,4,Sydney,2000
51,Argentina,ARG,0,2,3,5,Sydney,2000
52,Slovenia,SLO,0,2,2,4,Sydney,2000
53,Lithuania,LTU,0,2,1,3,Sydney,2000
54,Kuwait,KUW,0,1,4,5,Sydney,2000
55,Bahrain,BRN,0,1,1,2,Sydney,2000
55,Panama,PAN,0,1,1,2,Sydney,2000
56,Azerbaijan,AZE,0,1,0,1,Sydney,2000
56,Bosnia and Herzegovina,BIH,0,1,0,1,Sydney,2000
56,Yugoslavia,YUG,0,1,0,1,Sydney,2000
57,Latvia,LAT,0,0,3,3,Sydney,2000
58,Libya,LBA,0,0,1,1,Sydney,2000
58,Palestine,PLE,0,0,1,1,Sydney,2000
58,Philippines,PHI,0,0,1,1,Sydney,2000
58,Puerto Rico,PUR,0,0,1,1,Sydney,2000
58,Venezuela,VEN,0,0,1,1,Sydney,2000
1,Germany,GER,17,1,15,33,SaltLakeCity,2002
2,United States of America,USA,10,22,11,43,SaltLakeCity,2002
3,Norway,NOR,10,3,6,19,SaltLakeCity,2002
4,Austria,AUT,9,10,10,29,SaltLakeCity,2002
5,Russian Federation,RUS,7,9,5,21,SaltLakeCity,2002
6,Canada,CAN,6,4,5,15,SaltLakeCity,2002
7,Switzerland,SUI,6,4,2,12,SaltLakeCity,2002
8,Australia,AUS,6,1,0,7,SaltLakeCity,2002
9,Finland,FIN,4,1,3,8,SaltLakeCity,2002
10,New Zealand,NZL,4,0,2,6,SaltLakeCity,2002
11,Italy,ITA,3,3,3,9,SaltLakeCity,2002
12,Spain,ESP,3,2,2,7,SaltLakeCity,2002
13,France,FRA,2,11,6,19,SaltLakeCity,2002
14,Czech Republic,CZE,2,1,2,5,SaltLakeCity,2002
15,Netherlands,NED,1,3,0,4,SaltLakeCity,2002
16,Belarus,BLR,1,1,0,2,SaltLakeCity,2002
17,Poland,POL,1,0,2,3,SaltLakeCity,2002
18,Ukraine,UKR,0,6,6,12,SaltLakeCity,2002
19,Sweden,SWE,0,6,3,9,SaltLakeCity,2002
20,Slovakia,SVK,0,3,6,9,SaltLakeCity,2002
21,Republic of Korea,KOR,0,1,0,1,SaltLakeCity,2002
22,Japan,JPN,0,0,3,3,SaltLakeCity,2002
1,People's Republic of China,CHN,63,46,32,141,Athens,2004
2,Great Britain,GBR,35,30,29,94,Athens,2004
3,Canada,CAN,28,19,25,72,Athens,2004
4,United States of America,USA,27,22,39,88,Athens,2004
5,Australia,AUS,26,39,36,101,Athens,2004
6,Ukraine,UKR,24,12,19,55,Athens,2004
7,Spain,ESP,20,27,24,71,Athens,2004
8,Germany,GER,19,28,31,78,Athens,2004
9,France,FRA,18,26,30,74,Athens,2004
10,Japan,JPN,17,15,20,52,Athens,2004
11,Russian Federation,RUS,16,8,17,41,Athens,2004
12,Czech Republic,CZE,16,8,7,31,Athens,2004
13,South Africa,RSA,15,13,7,35,Athens,2004
14,Brazil,BRA,14,12,7,33,Athens,2004
15,Mexico,MEX,14,10,10,34,Athens,2004
16,Republic of Korea,KOR,11,11,6,28,Athens,2004
17,"Hong Kong, China",HKG,11,7,1,19,Athens,2004
18,Poland,POL,10,25,19,54,Athens,2004
19,Belarus,BLR,10,12,7,29,Athens,2004
20,Austria,AUT,8,10,4,22,Athens,2004
21,Sweden,SWE,8,7,6,21,Athens,2004
22,Tunisia,TUN,8,7,3,18,Athens,2004
23,Egypt,EGY,6,9,8,23,Athens,2004
24,Islamic Republic of Iran,IRI,6,3,13,22,Athens,2004
25,Algeria,ALG,6,2,5,13,Athens,2004
26,New Zealand,NZL,6,1,3,10,Athens,2004
27,Netherlands,NED,5,12,12,29,Athens,2004
28,Nigeria,NGR,5,4,3,12,Athens,2004
29,Denmark,DEN,5,3,7,15,Athens,2004
30,Slovakia,SVK,5,3,4,12,Athens,2004
31,Italy,ITA,4,8,7,19,Athens,2004
32,Israel,ISR,4,4,5,13,Athens,2004
33,Finland,FIN,4,1,3,8,Athens,2004
34,Greece,GRE,3,13,4,20,Athens,2004
35,Thailand,THA,3,6,6,15,Athens,2004
36,Belgium,BEL,3,2,2,7,Athens,2004
37,Kenya,KEN,3,1,3,7,Athens,2004
38,Norway,NOR,3,1,1,5,Athens,2004
39,Angola,ANG,3,0,0,3,Athens,2004
40,Switzerland,SUI,2,6,8,16,Athens,2004
41,Portugal,POR,2,5,5,12,Athens,2004
42,Morocco,MAR,2,4,0,6,Athens,2004
43,Cuba,CUB,2,2,7,11,Athens,2004
44,Chinese Taipei,TPE,2,2,2,6,Athens,2004
45,Azerbaijan,AZE,2,1,1,4,Athens,2004
46,Hungary,HUN,1,8,10,19,Athens,2004
47,Iceland,ISL,1,3,0,4,Athens,2004
48,Kuwait,KUW,1,2,3,6,Athens,2004
49,Slovenia,SLO,1,2,1,4,Athens,2004
50,Lithuania,LTU,1,1,5,7,Athens,2004
51,United Arab Emirates,UAE,1,1,2,4,Athens,2004
52,Latvia,LAT,1,1,1,3,Athens,2004
53,India,IND,1,0,1,2,Athens,2004
53,Iraq,IRQ,1,0,1,2,Athens,2004
53,Jamaica,JAM,1,0,1,2,Athens,2004
53,Turkey,TUR,1,0,1,2,Athens,2004
54,Bosnia and Herzegovina,BIH,1,0,0,1,Athens,2004
54,Botswana,BOT,1,0,0,1,Athens,2004
54,Cyprus,CYP,1,0,0,1,Athens,2004
54,Zimbabwe,ZIM,1,0,0,1,Athens,2004
55,Ireland,IRL,0,3,1,4,Athens,2004
56,Argentina,ARG,0,2,2,4,Athens,2004
57,Venezuela,VEN,0,1,2,3,Athens,2004
58,Jordan,JOR,0,1,1,2,Athens,2004
58,Palestine,PLE,0,1,1,2,Athens,2004
59,Bahrain,BRN,0,1,0,1,Athens,2004
59,Estonia,EST,0,1,0,1,Athens,2004
59,North Macedonia,MKD,0,1,0,1,Athens,2004
59,Panama,PAN,0,1,0,1,Athens,2004
60,Croatia,CRO,0,0,4,4,Athens,2004
61,Peru,PER,0,0,2,2,Athens,2004
61,Serbia and Montenegro,SCG,0,0,2,2,Athens,2004
62,Faroe Islands,FRO,0,0,1,1,Athens,2004
62,Puerto Rico,PUR,0,0,1,1,Athens,2004
62,Rwanda,RWA,0,0,1,1,Athens,2004
1,Russian Federation,RUS,13,13,7,33,Torino,2006
2,Germany,GER,8,5,5,18,Torino,2006
3,Ukraine,UKR,7,9,9,25,Torino,2006
4,France,FRA,7,2,6,15,Torino,2006
5,United States of America,USA,7,2,3,12,Torino,2006
6,Canada,CAN,5,3,5,13,Torino,2006
7,Austria,AUT,3,4,7,14,Torino,2006
8,Japan,JPN,2,5,2,9,Torino,2006
9,Italy,ITA,2,2,4,8,Torino,2006
10,Poland,POL,2,0,0,2,Torino,2006
11,Belarus,BLR,1,6,2,9,Torino,2006
12,Norway,NOR,1,1,3,5,Torino,2006
13,Australia,AUS,0,1,1,2,Torino,2006
13,Slovakia,SVK,0,1,1,2,Torino,2006
13,Spain,ESP,0,1,1,2,Torino,2006
13,Switzerland,SUI,0,1,1,2,Torino,2006
14,Czech Republic,CZE,0,1,0,1,Torino,2006
14,Great Britain,GBR,0,1,0,1,Torino,2006
15,Sweden,SWE,0,0,1,1,Torino,2006
1,People's Republic of China,CHN,89,70,52,211,Beijing,2008
2,Great Britain,GBR,42,29,31,102,Beijing,2008
3,United States of America,USA,36,35,28,99,Beijing,2008
4,Ukraine,UKR,24,18,32,74,Beijing,2008
5,Australia,AUS,23,29,27,79,Beijing,2008
6,South Africa,RSA,21,3,6,30,Beijing,2008
7,Canada,CAN,19,10,21,50,Beijing,2008
8,Russian Federation,RUS,18,23,22,63,Beijing,2008
9,Brazil,BRA,16,14,17,47,Beijing,2008
10,Spain,ESP,15,21,22,58,Beijing,2008
11,Germany,GER,14,25,20,59,Beijing,2008
12,France,FRA,12,21,19,52,Beijing,2008
13,Republic of Korea,KOR,10,8,13,31,Beijing,2008
14,Mexico,MEX,10,3,7,20,Beijing,2008
15,Tunisia,TUN,9,9,3,21,Beijing,2008
16,Czech Republic,CZE,6,3,18,27,Beijing,2008
17,Japan,JPN,5,14,8,27,Beijing,2008
18,Poland,POL,5,12,13,30,Beijing,2008
19,Netherlands,NED,5,10,7,22,Beijing,2008
20,Greece,GRE,5,9,10,24,Beijing,2008
21,Belarus,BLR,5,7,1,13,Beijing,2008
22,Islamic Republic of Iran,IRI,5,6,3,14,Beijing,2008
23,Cuba,CUB,5,3,6,14,Beijing,2008
24,New Zealand,NZL,5,3,4,12,Beijing,2008
24,Sweden,SWE,5,3,4,12,Beijing,2008
25,"Hong Kong, China",HKG,5,3,3,11,Beijing,2008
26,Kenya,KEN,5,3,1,9,Beijing,2008
27,Italy,ITA,4,7,7,18,Beijing,2008
28,Egypt,EGY,4,4,4,12,Beijing,2008
29,Nigeria,NGR,4,4,1,9,Beijing,2008
30,Algeria,ALG,4,3,8,15,Beijing,2008
31,Morocco,MAR,4,1,2,7,Beijing,2008
32,Austria,AUT,4,1,1,6,Beijing,2008
33,Switzerland,SUI,3,2,6,11,Beijing,2008
34,Denmark,DEN,3,2,4,9,Beijing,2008
35,Ireland,IRL,3,1,1,5,Beijing,2008
36,Croatia,CRO,3,1,0,4,Beijing,2008
37,Azerbaijan,AZE,2,3,5,10,Beijing,2008
38,Slovakia,SVK,2,3,1,6,Beijing,2008
39,Finland,FIN,2,2,2,6,Beijing,2008
40,Thailand,THA,1,5,7,13,Beijing,2008
41,Portugal,POR,1,4,2,7,Beijing,2008
42,Norway,NOR,1,3,3,7,Beijing,2008
43,Cyprus,CYP,1,2,1,4,Beijing,2008
44,Latvia,LAT,1,2,0,3,Beijing,2008
45,Singapore,SGP,1,1,2,4,Beijing,2008
45,Venezuela,VEN,1,1,2,4,Beijing,2008
46,Saudi Arabia,KSA,1,1,0,2,Beijing,2008
47,Hungary,HUN,1,0,5,6,Beijing,2008
48,Chinese Taipei,TPE,1,0,1,2,Beijing,2008
48,Turkey,TUR,1,0,1,2,Beijing,2008
49,Mongolia,MGL,1,0,0,1,Beijing,2008
50,Israel,ISR,0,5,1,6,Beijing,2008
51,Angola,ANG,0,3,0,3,Beijing,2008
52,Jordan,JOR,0,2,2,4,Beijing,2008
53,Lithuania,LTU,0,2,0,2,Beijing,2008
53,Serbia,SRB,0,2,0,2,Beijing,2008
54,Argentina,ARG,0,1,5,6,Beijing,2008
55,Slovenia,SLO,0,1,2,3,Beijing,2008
56,Bulgaria,BUL,0,1,1,2,Beijing,2008
56,Colombia,COL,0,1,1,2,Beijing,2008
56,Iraq,IRQ,0,1,1,2,Beijing,2008
57,Bosnia and Herzegovina,BIH,0,1,0,1,Beijing,2008
57,Pakistan,PAK,0,1,0,1,Beijing,2008
57,Papua New Guinea,PNG,0,1,0,1,Beijing,2008
57,Romania,ROU,0,1,0,1,Beijing,2008
57,United Arab Emirates,UAE,0,1,0,1,Beijing,2008
58,Lebanon,LBN,0,0,2,2,Beijing,2008
59,Belgium,BEL,0,0,1,1,Beijing,2008
59,Estonia,EST,0,0,1,1,Beijing,2008
59,Jamaica,JAM,0,0,1,1,Beijing,2008
59,Lao People's Democratic Republic,LAO,0,0,1,1,Beijing,2008
59,Malaysia,MAS,0,0,1,1,Beijing,2008
59,Namibia,NAM,0,0,1,1,Beijing,2008
59,Puerto Rico,PUR,0,0,1,1,Beijing,2008
59,Syrian Arab Republic,SYR,0,0,1,1,Beijing,2008
1,Germany,GER,13,5,6,24,Vancouver,2010
2,Russian Federation,RUS,12,16,10,38,Vancouver,2010
3,Canada,CAN,10,5,4,19,Vancouver,2010
4,Slovakia,SVK,6,2,3,11,Vancouver,2010
5,Ukraine,UKR,5,8,6,19,Vancouver,2010
6,United States of America,USA,4,5,4,13,Vancouver,2010
7,Austria,AUT,3,4,4,11,Vancouver,2010
8,Japan,JPN,3,3,5,11,Vancouver,2010
9,Belarus,BLR,2,0,7,9,Vancouver,2010
10,France,FRA,1,4,1,6,Vancouver,2010
11,Italy,ITA,1,3,3,7,Vancouver,2010
12,Norway,NOR,1,3,2,6,Vancouver,2010
13,Spain,ESP,1,2,0,3,Vancouver,2010
13,Switzerland,SUI,1,2,0,3,Vancouver,2010
14,New Zealand,NZL,1,0,0,1,Vancouver,2010
15,Australia,AUS,0,1,3,4,Vancouver,2010
16,Finland,FIN,0,1,1,2,Vancouver,2010
17,Republic of Korea,KOR,0,1,0,1,Vancouver,2010
18,Sweden,SWE,0,0,2,2,Vancouver,2010
19,Czech Republic,CZE,0,0,1,1,Vancouver,2010
19,Poland,POL,0,0,1,1,Vancouver,2010
1,People's Republic of China,CHN,95,71,65,231,London,2012
2,Russian Federation,RUS,36,38,28,102,London,2012
3,Great Britain,GBR,34,43,43,120,London,2012
4,Ukraine,UKR,32,24,28,84,London,2012
5,Australia,AUS,32,23,30,85,London,2012
6,United States of America,USA,31,29,38,98,London,2012
7,Brazil,BRA,21,14,8,43,London,2012
8,Germany,GER,18,26,22,66,London,2012
9,Poland,POL,14,13,9,36,London,2012
10,Netherlands,NED,10,10,19,39,London,2012
11,Islamic Republic of Iran,IRI,10,7,7,24,London,2012
12,Republic of Korea,KOR,9,9,9,27,London,2012
13,Italy,ITA,9,8,11,28,London,2012
14,Tunisia,TUN,9,5,5,19,London,2012
15,Cuba,CUB,9,5,3,17,London,2012
16,France,FRA,8,19,18,45,London,2012
17,Spain,ESP,8,18,16,42,London,2012
18,South Africa,RSA,8,12,9,29,London,2012
19,Ireland,IRL,8,3,5,16,London,2012
20,Canada,CAN,7,15,9,31,London,2012
21,New Zealand,NZL,6,7,4,17,London,2012
22,Nigeria,NGR,6,5,2,13,London,2012
23,Mexico,MEX,6,4,11,21,London,2012
24,Japan,JPN,5,5,6,16,London,2012
25,Belarus,BLR,5,2,3,10,London,2012
26,Algeria,ALG,4,6,9,19,London,2012
27,Azerbaijan,AZE,4,5,3,12,London,2012
28,Egypt,EGY,4,4,7,15,London,2012
29,Sweden,SWE,4,4,4,12,London,2012
30,Austria,AUT,4,3,6,13,London,2012
31,Thailand,THA,4,2,2,8,London,2012
32,Finland,FIN,4,1,1,6,London,2012
33,Switzerland,SUI,3,6,4,13,London,2012
34,"Hong Kong, China",HKG,3,3,6,12,London,2012
35,Norway,NOR,3,2,3,8,London,2012
36,Belgium,BEL,3,1,3,7,London,2012
37,Morocco,MAR,3,0,3,6,London,2012
38,Hungary,HUN,2,6,6,14,London,2012
39,Serbia,SRB,2,3,0,5,London,2012
40,Kenya,KEN,2,2,2,6,London,2012
41,Slovakia,SVK,2,1,3,6,London,2012
42,Czech Republic,CZE,1,6,4,11,London,2012
43,Turkey,TUR,1,5,4,10,London,2012
44,Greece,GRE,1,3,8,12,London,2012
45,Israel,ISR,1,2,5,8,London,2012
46,United Arab Emirates,UAE,1,1,1,3,London,2012
47,Latvia,LAT,1,1,0,2,London,2012
47,Namibia,NAM,1,1,0,2,London,2012
47,Romania,ROU,1,1,0,2,London,2012
48,Denmark,DEN,1,0,4,5,London,2012
49,Angola,ANG,1,0,1,2,London,2012
50,Bosnia and Herzegovina,BIH,1,0,0,1,London,2012
50,Chile,CHI,1,0,0,1,London,2012
50,Fiji,FIJ,1,0,0,1,London,2012
50,Iceland,ISL,1,0,0,1,London,2012
50,Jamaica,JAM,1,0,0,1,London,2012
50,North Macedonia,MKD,1,0,0,1,London,2012
51,Croatia,CRO,0,2,3,5,London,2012
52,Bulgaria,BUL,0,2,1,3,London,2012
52,Iraq,IRQ,0,2,1,3,London,2012
53,Colombia,COL,0,2,0,2,London,2012
54,Argentina,ARG,0,1,4,5,London,2012
55,Chinese Taipei,TPE,0,1,2,3,London,2012
55,Portugal,POR,0,1,2,3,London,2012
56,Malaysia,MAS,0,1,1,2,London,2012
56,Singapore,SGP,0,1,1,2,London,2012
57,Cyprus,CYP,0,1,0,1,London,2012
57,Ethiopia,ETH,0,1,0,1,London,2012
57,India,IND,0,1,0,1,London,2012
57,Saudi Arabia,KSA,0,1,0,1,London,2012
57,Slovenia,SLO,0,1,0,1,London,2012
57,Uzbekistan,UZB,0,1,0,1,London,2012
58,Venezuela,VEN,0,0,2,2,London,2012
59,Indonesia,INA,0,0,1,1,London,2012
59,Sri Lanka,SRI,0,0,1,1,London,2012
1,Russian Federation,RUS,30,28,22,80,Sochi,2014
2,Germany,GER,9,5,1,15,Sochi,2014
3,Canada,CAN,7,2,7,16,Sochi,2014
4,Ukraine,UKR,5,9,11,25,Sochi,2014
5,France,FRA,5,3,4,12,Sochi,2014
6,Slovakia,SVK,3,2,2,7,Sochi,2014
7,Japan,JPN,3,1,2,6,Sochi,2014
8,United States of America,USA,2,7,9,18,Sochi,2014
9,Austria,AUT,2,5,4,11,Sochi,2014
10,Great Britain,GBR,1,3,2,6,Sochi,2014
11,Norway,NOR,1,2,1,4,Sochi,2014
11,Sweden,SWE,1,2,1,4,Sochi,2014
12,Spain,ESP,1,1,1,3,Sochi,2014
13,Netherlands,NED,1,0,0,1,Sochi,2014
13,Switzerland,SUI,1,0,0,1,Sochi,2014
14,Finland,FIN,0,1,0,1,Sochi,2014
14,New Zealand,NZL,0,1,0,1,Sochi,2014
15,Belarus,BLR,0,0,3,3,Sochi,2014
16,Australia,AUS,0,0,2,2,Sochi,2014
1,People's Republic of China,CHN,107,81,51,239,Rio,2016
2,Great Britain,GBR,64,39,44,147,Rio,2016
3,Ukraine,UKR,41,37,39,117,Rio,2016
4,United States of America,USA,40,44,31,115,Rio,2016
5,Australia,AUS,22,30,29,81,Rio,2016
6,Germany,GER,18,25,14,57,Rio,2016
7,Netherlands,NED,17,19,26,62,Rio,2016
8,Brazil,BRA,14,29,29,72,Rio,2016
9,Italy,ITA,10,14,15,39,Rio,2016
10,Poland,POL,9,18,12,39,Rio,2016
11,Spain,ESP,9,14,8,31,Rio,2016
12,France,FRA,9,5,14,28,Rio,2016
13,New Zealand,NZL,9,5,7,21,Rio,2016
14,Canada,CAN,8,10,11,29,Rio,2016
15,Islamic Republic of Iran,IRI,8,9,7,24,Rio,2016
16,Uzbekistan,UZB,8,6,17,31,Rio,2016
17,Nigeria,NGR,8,2,2,12,Rio,2016
18,Cuba,CUB,8,1,6,15,Rio,2016
19,Belarus,BLR,8,0,2,10,Rio,2016
20,Republic of Korea,KOR,7,11,17,35,Rio,2016
21,Tunisia,TUN,7,6,6,19,Rio,2016
22,South Africa,RSA,7,6,4,17,Rio,2016
23,Thailand,THA,6,6,6,18,Rio,2016
24,Greece,GRE,5,4,4,13,Rio,2016
25,Belgium,BEL,5,3,3,11,Rio,2016
25,Slovakia,SVK,5,3,3,11,Rio,2016
26,Algeria,ALG,4,5,7,16,Rio,2016
27,Ireland,IRL,4,4,3,11,Rio,2016
28,Mexico,MEX,4,2,9,15,Rio,2016
29,Egypt,EGY,3,5,4,12,Rio,2016
30,Serbia,SRB,3,2,4,9,Rio,2016
31,Norway,NOR,3,2,3,8,Rio,2016
32,Morocco,MAR,3,2,2,7,Rio,2016
33,Turkey,TUR,3,1,5,9,Rio,2016
34,Kenya,KEN,3,1,2,6,Rio,2016
35,Malaysia,MAS,3,0,1,4,Rio,2016
36,Colombia,COL,2,5,10,17,Rio,2016
37,United Arab Emirates,UAE,2,4,1,7,Rio,2016
38,Iraq,IRQ,2,3,0,5,Rio,2016
39,"Hong Kong, China",HKG,2,2,2,6,Rio,2016
40,Croatia,CRO,2,2,1,5,Rio,2016
40,Switzerland,SUI,2,2,1,5,Rio,2016
41,India,IND,2,1,1,4,Rio,2016
42,Lithuania,LTU,2,1,0,3,Rio,2016
43,Latvia,LAT,2,0,2,4,Rio,2016
44,Singapore,SGP,2,0,1,3,Rio,2016
45,Hungary,HUN,1,8,9,18,Rio,2016
46,Azerbaijan,AZE,1,8,2,11,Rio,2016
47,Sweden,SWE,1,4,5,10,Rio,2016
48,Austria,AUT,1,4,4,9,Rio,2016
49,Czech Republic,CZE,1,2,4,7,Rio,2016
49,Denmark,DEN,1,2,4,7,Rio,2016
50,Namibia,NAM,1,2,2,5,Rio,2016
51,Argentina,ARG,1,1,3,5,Rio,2016
52,Vietnam,VIE,1,1,2,4,Rio,2016
53,Finland,FIN,1,1,1,3,Rio,2016
53,Trinidad and Tobago,TTO,1,1,1,3,Rio,2016
54,Kazakhstan,KAZ,1,1,0,2,Rio,2016
54,Slovenia,SLO,1,1,0,2,Rio,2016
55,Bahrain,BRN,1,0,0,1,Rio,2016
55,Bulgaria,BUL,1,0,0,1,Rio,2016
55,Georgia,GEO,1,0,0,1,Rio,2016
55,Kuwait,KUW,1,0,0,1,Rio,2016
56,Japan,JPN,0,10,14,24,Rio,2016
57,Venezuela,VEN,0,3,3,6,Rio,2016
58,Jordan,JOR,0,2,1,3,Rio,2016
59,Qatar,QAT,0,2,0,2,Rio,2016
60,Chinese Taipei,TPE,0,1,1,2,Rio,2016
61,Bosnia and Herzegovina,BIH,0,1,0,1,Rio,2016
61,Côte d'Ivoire,CIV,0,1,0,1,Rio,2016
61,Ethiopia,ETH,0,1,0,1,Rio,2016
61,Uganda,UGA,0,1,0,1,Rio,2016
62,Portugal,POR,0,0,4,4,Rio,2016
63,Israel,ISR,0,0,3,3,Rio,2016
64,Mongolia,MGL,0,0,2,2,Rio,2016
65,Cape Verde,CPV,0,0,1,1,Rio,2016
65,Indonesia,INA,0,0,1,1,Rio,2016
65,Mozambique,MOZ,0,0,1,1,Rio,2016
65,Pakistan,PAK,0,0,1,1,Rio,2016
65,Philippines,PHI,0,0,1,1,Rio,2016
65,Romania,ROU,0,0,1,1,Rio,2016
65,Saudi Arabia,KSA,0,0,1,1,Rio,2016
65,Sri Lanka,SRI,0,0,1,1,Rio,2016
1,United States of America,USA,13,15,8,36,PyeongChang,2018
3,Canada,CAN,8,4,16,28,PyeongChang,2018
4,France,FRA,7,8,5,20,PyeongChang,2018
5,Germany,GER,7,8,4,19,PyeongChang,2018
6,Ukraine,UKR,7,7,8,22,PyeongChang,2018
7,Slovakia,SVK,6,4,1,11,PyeongChang,2018
8,Belarus,BLR,4,4,4,12,PyeongChang,2018
9,Japan,JPN,3,4,3,10,PyeongChang,2018
10,Netherlands,NED,3,3,1,7,PyeongChang,2018
11,Switzerland,SUI,3,0,0,3,PyeongChang,2018
12,Italy,ITA,2,2,1,5,PyeongChang,2018
13,Great Britain,GBR,1,4,2,7,PyeongChang,2018
14,Norway,NOR,1,3,4,8,PyeongChang,2018
15,Australia,AUS,1,0,3,4,PyeongChang,2018
16,Finland,FIN,1,0,2,3,PyeongChang,2018
16,Republic of Korea,KOR,1,0,2,3,PyeongChang,2018
16,New Zealand,NZL,1,0,2,3,PyeongChang,2018
17,Croatia,CRO,1,0,1,2,PyeongChang,2018
18,People's Republic of China,CHN,1,0,0,1,PyeongChang,2018
18,Kazakhstan,KAZ,1,0,0,1,PyeongChang,2018
19,Austria,AUT,0,2,5,7,PyeongChang,2018
20,Spain,ESP,0,1,1,2,PyeongChang,2018
21,Sweden,SWE,0,1,0,1,PyeongChang,2018
22,Belgium,BEL,0,0,1,1,PyeongChang,2018
22,Poland,POL,0,0,1,1,PyeongChang,2018